[console_scripts]
alarmclk = pycmd2.commands.system.alarmclock.cli:main
checksum = pycmd2.commands.system.checksum.checksum:main
docdiff = pycmd2.commands.office.doc_diff:cli.app
encz = pycmd2.commands.system.encrypt_zip:cli.app
envt = pycmd2.commands.dev.envtools.cli:cli.app
filedate = pycmd2.commands.system.file_date:cli.app
filelvl = pycmd2.commands.system.file_level:cli.app
folderb = pycmd2.commands.system.folder_backup:cli.app
folderz = pycmd2.commands.system.folder_zip:cli.app
gitt = pycmd2.commands.dev.gittools.cli:cli.app
img2pdf = pycmd2.commands.office.image_to_pdf:cli.app
imggry = pycmd2.commands.office.image_gray:cli.app
ld = pycmd2.commands.system.list_dirs:cli.app
llmcli = pycmd2.commands.office.llama_client:main
llmqnt = pycmd2.commands.office.llama_quantize:main
llmsvr = pycmd2.commands.office.llama_server:main
mindnote = pycmd2.commands.office.mindnote.cli:main
mkp = pycmd2.commands.dev.makepython.cli:cli.app
pdfc = pycmd2.commands.office.pdf_crypt:cli.app
pdfmrg = pycmd2.commands.office.pdf_merge:cli.app
pdfspl = pycmd2.commands.office.pdf_split:cli.app
pdft = pycmd2.commands.office.pdftools.cli:main
pdftw = pycmd2.commands.office.pdftoolweb.cli:main
pipt = pycmd2.commands.dev.piptools:cli.app
pycmd2 = pycmd2.cli:cli.app
ssh-copy-id = pycmd2.commands.dev.ssh_copy_id:cli.app
taskk = pycmd2.commands.system.task_kill:cli.app
todo = pycmd2.commands.office.todo.cli:main
videoconv = pycmd2.commands.office.video_converter:main
wch = pycmd2.commands.system.which:cli.app
websvr = pycmd2.websvr.cli:app
